# # # # # # # # # # # # # # # #
# . . . # . . . . . . . . . . #
# . # . # . # # # # # # # # . #
# . # . . . . . . . . . . # . #
# . # # # # # # # . # # . # . #
# . . . . . . . # . # . . # . #
# # # # # # # . # . # . # # . #
# . . . . . . . # . . . # . . #
# . # # # . # # # # # # # . # #
# . . . # . . . . . . . . . # #
# # # . # # # # # . # # # # # #
# . . . . . . . # . . . . . . #
# . # # # # # . # # # # # # . #
# . . . . . # . . . . . . # . #
# . . . . . # . . . . . . . . #
# # # # # # # # # # # # # # # #