# # # # # # # # # # # # # # # # # # # #
# . . . . ~ ~ ~ ~ ~ . . . . . * * * . #
# . # # . ~ . . . ~ . # # # . * . * . #
# . . . . ~ . # . ~ . . . . . * . * . #
# # # # . ~ . # . ~ ~ ~ ~ . # * . * . #
# . . . . ~ . # . . . . ~ . # * . * . #
# . # # # ~ . # # # # . ~ . # * * * . #
# . . . . ~ . . . . # . ~ . . . . . . #
# . # . # ~ ~ ~ ~ . # . ~ ~ ~ ~ # # . #
# . # . # . . . ~ . # . . . . . # . . #
# . # . # # # . ~ . # # # # # . # . # #
# . . . . . # . ~ . . . . . # . . . # #
# # # # # . # . ~ ~ ~ ~ ~ . # # # . # #
# . . . . . # . . . . . ~ . . . . . . #
# . # # # . # # # # # . ~ . # # # # . #
# . . . # . . . . . . . ~ . . . . . . #
# . # . # . # * * * # . ~ ~ ~ ~ ~ ~ . #
# . # . . . # * . * # . . . . . . . . #
# . . . . . . * * * . . . . . . . . . #
# # # # # # # # # # # # # # # # # # # #