# # # # # # # # # 
# . . . # . . . #
# . . . # . . . # 
# # # # # # # # #
# . . . # . . . # 
# . . . # . . . # 
# . . . # . . . #
# # # # # # # # #