# # # # # # # # # # # # # # # # # # # #
# . . . . . # . . . . . . # . . . . . #
# . # # # . # . # # # # . # . # # # . #
# . . . # . . . . . . . . . . # . . . #
# # # . # # # # # . # # # # # # . # # #
# . . . . . . . . . . . . . . . . . . #
# . # # # # # . # # # # . # # # # # . #
# . . . . . . . . . . . . . . . . . . #
# # # . # . # # # . # # # . # . # # # #
# . . . # . . . . . . . . . # . . . . #
# . # # # # # . # ~ # . # # # # # . # #
# . . . . . . . # ~ # . . . . . . . . #
# # # . # . # # # ~ # # # . # . # # # #
# . . . # . . . . ~ . . . . # . . . . #
# . # # # # # . # ~ # . # # # # # . # #
# . . . . . . . # ~ # . . . . . . . . #
# . # . # . # . # ~ # . # . # . # . # #
# . . . . . . . . ~ . . . . . . . . . #
# . . * * * * * * * * * * * * * * . . #
# # # # # # # # # # # # # # # # # # # #