# # # # # # # # # # # # # # # # #
# . . . . . . . . . . . . . . . #
# . # # # # # . # # # # # # . . #
# . . . . . . . . . . . . . . . #
# . . . ~ ~ ~ ~ ~ ~ ~ ~ . . . . #
# . . . . . . . . . . . . . . . #
# . # # # # # . # # # # # # . . #
# . . . . . . . . . . . . . . . #
# . . . * * * * * * * * . . . . #
# . . . . . . . . . . . . . . . #
# . # # # # # . # # # # # # . . #
# . . . . . . . . . . . . . . . #
# # # # # # # # # # # # # # # # #