# # # # # # # # # 
# . # . . . # . #
# . . . # # # . # 
# ~ ~ ~ ~ ~ ~ . #
# # # # . # . . # 
# . . . . # . # # 
# . # # . # . # #
# # # # # # # # # 
